antithesis	rst
background	rst
cause	rst
circumstance	rst
concession	rst
condition	rst
contrast	multinuc
elaboration	rst
evaluation	rst
evidence	rst
joint	multinuc
justify	rst
motivation	rst
preparation	rst
purpose	rst
restatement	multinuc
restatement	rst
result	rst
sequence	multinuc
solutionhood	rst